WWWWWWWWWWWWWWWWWWW
W...W.....WBBBBB..W
W.W.W.W.W.W.W.W.WBW
W...W.....W..B..BBW
W.W.W.WWW.W.WWWBW.W
W.........WB..BBB.W
WBWWW.W.W.WBWBWWW.W
W.......W...B.B..BW
W.WBWWW.W.WWW.WBW.W
W.......W..B...B..W
WWWBWWW.W.W.WBWWW.W
W.....BBBB......B.W
WWWWWWWWWWWWWWWWWWW