WWWWWWWWWWWWWWW
W....BBBBB....W
W.W.WWW.WWW.W.W
W.W...BBB...WBW
WBWBW.WWWBW.W.W
WBW.WBBB.BWBWBW
WBW.B.WWWBBBW.W
WBWBW...B.W.WBW
WBW.W.WWWBWBWBW
WBW.BB......W.W
W.W.WWW.WWWBW.W
W.............W
WWWWWWWWWWWWWWW