WWWWWWWWWWWWWWW
W.............W
W.W.W.W.W.W.W.W
W.............W
W.W.W.W.W.W.W.W
W.............W
W.W.W.W.W.W.W.W
W.............W
W.W.W.W.W.W.W.W
W.............W
W.W.W.W.W.W.W.W
W.............W
WWWWWWWWWWWWWWW