WWWWWWWWWWWWWWW
Wp..BBB.BBBB..W
W.WBWBWBWBW.W.W
W.B.BBBBB.....W
W.WBWBWBWBW.WBW
WBBBB.B.B...BBW
W.W.WBWBW.WBWBW
WBB..B........W
WBW.W.WBW.W.WBW
W....BB......BW
W.W.W.WBW.W.W.W
W....BB..BBB..W
WWWWWWWWWWWWWWW