WWWWWWWWWWWWWWWWWWW
W...B........B....W
W.W.W.WBW.W.WBW.W.W
W...WBB....BBBW...W
W.WWW.W.W.WBW.WWWBW
W......BW.W.BB..BBW
WBW.W.WBW.WBWBW.W.W
WB..........BBB..BW
WBWWW.WWW.WWW.WWWBW
W...W......BB.W..BW
W.W.WBW.W.WBW.W.W.W
W...BB......B.B...W
WWWWWWWWWWWWWWWWWWW